{
 "width":20,
 "height":20,
 "tiles":[
  [1,1,1,1,1,1,1,1,1,1,1,1,1,1,1,1,1,1,1,1],
  [1,2,2,2,2,2,2,2,2,2,2,2,2,2,2,2,2,2,2,1],
  [1,2,2,2,2,2,2,2,2,2,2,2,2,2,2,2,2,2,2,1],
  [1,2,2,2,2,2,2,2,2,2,2,2,2,2,2,2,2,2,2,1],
  [1,2,2,2,2,2,2,2,2,2,2,2,2,2,2,2,2,2,2,1],
  [1,2,2,2,2,2,2,2,2,2,2,2,2,2,2,2,2,2,2,1],
  [1,2,2,2,2,2,2,2,2,2,2,2,2,2,2,2,2,2,2,1],
  [1,2,2,2,2,2,2,2,2,2,2,2,2,2,2,2,2,2,2,1],
  [1,2,2,2,2,2,2,2,2,2,2,2,2,2,2,2,2,2,2,1],
  [1,2,2,2,2,2,2,2,2,2,2,2,2,2,2,2,2,2,2,1],
  [1,2,2,2,2,2,2,2,2,2,2,2,2,2,2,2,2,2,2,1],
  [1,2,2,2,2,2,2,2,2,2,2,2,2,2,2,2,2,2,2,1],
  [1,2,2,2,2,2,2,2,2,2,2,2,2,2,2,2,2,2,2,1],
  [1,2,2,2,2,2,2,2,2,2,2,2,2,2,2,2,2,2,2,1],
  [1,2,2,2,2,2,2,2,2,2,2,2,2,2,2,2,2,2,2,1],
  [1,2,2,2,2,2,2,2,2,2,2,2,2,2,2,2,2,2,2,1],
  [1,2,2,2,2,2,2,2,2,2,2,2,2,2,2,2,2,2,2,1],
  [1,2,2,2,2,2,2,2,2,2,2,2,2,2,2,2,2,2,2,1],
  [1,2,2,2,2,2,2,2,2,2,2,2,2,2,2,2,2,2,2,1],
  [1,1,1,1,1,1,1,1,1,1,1,1,1,1,1,1,1,1,1,1]
 ],
 "objects":[
  {"type":"chest","x":5,"y":5},
  {"type":"chest","x":10,"y":10},
  {"type":"chest","x":15,"y":15}
 ]
}